*
+
/
2	T UW
8	EY T
9	N AY N
A	AH
A(2)	EY
ABIOTIC	AH B AY AA T IH K
ACCEPTED	AE K S EH P T IH D
ACID	AE S AH D
ACTIVATOR	AE K T AH V EY T ER
ADHERENCE	AH D HH IH R AH N S
ADULT	AH D AH L T
ADULT(2)	AE D AH L T
AEROBE	AH R OW B
AGAR	EY G ER
AGAROSE	AE G AH R OW Z
AGENTS	EY JH AH N T S
AGROBACTERIUM	AE G R AH B AH K T IY R IY AH M
ALCALASE	AE L K AH L EY Z
ALKALINE	AE L K AH L AY N
AMINO	AH M IY N OW
ANALYSIS	AE N AE L IH S IH S
AND	AH N D
AND(2)	AE N D
ANNEALING	AH N IY L IH NG
ANTIBODIES	AE N T IH B AA D IY Z
ANTIBODIES(2)	AE N T IY B AA D IY Z
ANTIBODIES(3)	AE N IH B AA D IY Z
ANTIFOAMING	AE N T AY F OW M IH NG
ANTISENSE	AE N T IY S EH N S
ANTISENSE(2)	AE N T AY S EH N S
APPROACH	AH P R OW CH
AQUEOUS	EY K W IY AH S
ARTEMICIN	AA R T EH M AH S AH N
ARTIFICIAL	AA R T AH F IH SH AH L
ASSAY	AE S IY
ASSISTED	AH S IH S T AH D
ASSISTED(2)	AH S IH S T IH D
AUTOMATED	AO T AH M EY T IH D
AUTORADIOGRAPHY	AO T OW R EY D IY AA G R AH F IY
AUXINS	AO K S AH N Z
AZADIRACTIN	AE Z AH D AH R AE K T AH N
B	B IY
BACILLUS	B AH S IH L AH S
BACTERIA	B AE K T IH R IY AH
BACTERIAL	B AE K T IH R IY AH L
BACTERIOPHAGE	B AE K T AH R IY AH F AH JH
BAFFLE	B AE F AH L
BAKERS	B EY K ER Z
BANK	B AE NG K
BANKS	B AE NG K S
BATCH	B AE CH
BEADS	B IY D Z
BEBEERINE	B IH B AH AH R AY N
BI	B AY
BICARBONATE	B AY K AA R B AH N AH T
BIOCHEMICAL	B AY OW K EH M IH K AH L
BIODEGRADABLE	B AY OW D AH G R EY D AH B AH L
BIOINFORMATICS	B AY OY N F AO R M AH T AH S Z
BIOLISTICS	B AY AH L IH S T AH S Z
BIOLOGICAL	B AY AH L AA JH IH K AH L
BIOLOGY	B AY AA L AH JH IY
BIOMASS	B AY AH M AE S
BIOPESTICIDES	B AY AH P EH S T AH S AY D Z
BIOPROCESS	B AY AA P R AH S AH S
BIOREACTOR	B AY OW R AE K T ER
BIOREACTORS	B AY OW R AE K T ER Z
BIOREMEDIATION	B AY OW R M IY D IY EY SH AH N
BIOTIC	B AY AA T IH K
BLAST	B L AE S T
BLOTTING	B L AA T IH NG
BLUE	B L UW
BODIES	B AA D IY Z
BOND	B AA N D
BOTTLES	B AA T AH L Z
BRANCHED	B R AE N CH T
BREWERS	B R UW ER Z
BRIDGES	B R IH JH AH Z
BRIDGES(2)	B R IH JH IH Z
BROTH	B R AO TH
BROWSER	B R AW Z ER
BUFFER	B AH F ER
C	S IY
CALLUS	K AE L AH S
CAPSAICIN	K AE P S EY S AH N
CARRIER	K AE R IY ER
CARRIER(2)	K EH R IY ER
CASEIN	K EY S IY N
CATALYTIC	K AE T AH L IH T IH K
CELL	S EH L
CELL(2) S EY L
CELLS	S EH L Z
CENTERS	S EH N T ER Z
CENTERS(2)	S EH N ER Z
CHAIN	CH EY N
CHARACTERISATION	K AE R IH K T ER IY Z EY SH AH N
CHARGE	CH AA R JH
CHEMICAL	K EH M IH K AH L
CHEMOSTAT	K AH M AA S T AH T
CHIMERIC	CH AY M ER IH K
CHROMATOGRAPHY	K R OW M AH T AA G R AH F IY
CHROMOSOME	K R OW M AH S OW M
CHROMOSOME(2)	K R OW M AH Z OW M
CHRONIC	K R AA N IH K
CLONAL	K L OW N AH L
CLONE	K L OW N
CLONING	K L OW N IH NG
CO	K OW
COLLECTIONS	K AH L EH K SH AH N Z
COMPETENCE	K AA M P AH T IH N S
CONSERVATION	K AA N S ER V EY SH AH N
CONTACT	K AA N T AE K T
CONTIGS	K AA N T IH G Z
CONTINUOUS	K AH N T IH N Y UW AH S
COSMID	K AA S M IH D
COUNTING	K AW N T IH NG
CRYOPRESERVATION	K R AY AA P R EH S AH R V EY SH AH N
CRYOPROTECTANT	K R AY AA P R AH T EH K T AH N T
CULTIVATION	K AH L T IH V EY SH AH N
CULTURE	K AH L CH ER
CULTURES	K AH L CH ER Z
CULTURING	K AH L CH ER IH NG
CURATOR	K Y UH R EY T ER
CURATOR(2)	K Y UH R AH T ER
CYBRID	S IH B R AH D
CYBRIDIZATION	S IH B R AH D AH Z EY SH AH N
CYSTEINYL	S IH S T IY N AH L
CYTOKINES	S IH T AH K AY N Z
CYTOTOXICITY	S IH T AH T AA K S IH S AH T IY
D	D IY
DATABASE	D EY T AH B EY S
DATABASE(2)	D AE T AH B EY S
DELAYED	D IH L EY D
DEMAND	D IH M AE N D
DER	D ER
DESORPTION	D IY S AO R P SH AH N
DIAZOTROPHS	D AY AH Z AA T R AH F S
DIGOXIN	D IH G AA K S IH N
DIRECTED	D ER EH K T AH D
DIRECTED(2)	D ER EH K T IH D
DIRECTED(3)	D AY R EH K T IH D
DIRECTED(4)	D IH R EH K T IH D
DOUBLING	D AH B AH L IH NG
DOUBLING(2)	D AH B L IH NG
DOWNSTREAM	D AW N S T R IY M
E	IY
EDIBLE	EH D AH B AH L
ELECTRIC	IH L EH K T R IH K
ELECTROPHORESIS	IH L EH K T R OW F AO R IH S IH S
ELECTROPORATION	IH L EH K T R OW P ER EY SH AH N
ELISA	AH L IY S AH
ELISA(2)	AH L IY Z AH
EMBRYO	EH M B R IY OW
EMBRYOGENESIS	EH M B R IY OW JH EH N AH S AH S
EMBRYONIC	EH M B R IY AA N IH K
ENCAPSULATION	EH N K AE P S AH L EY SH AH N
ENDONUCLEASE	IH N D AA N AH K L IY Z
ENGINEERING	EH N JH AH N IH R IH NG
ENRICHMENT	EH N R IH CH M AH N T
ENRICHMENT(2)	IH N R IH CH M AH N T
ENTREZ	IH N T R EH Z
ENZYME	EH N Z AY M
ERYTHROPOETIN	AH R IH TH R AH P OW AH T AH N
ERYTHROPOIETIN	EH R IH TH R AH P OY T IH N
ESSENTIAL	EH S EH N SH AH L
ESSENTIAL(2)	IY S EH N SH AH L
EUROPEAN	Y UH R AH P IY AH N
EXPLANT	EH K S P L AE N T
EXPONENTIAL	EH K S P OW N EH N SH AH L
EXPRESSED	IH K S P R EH S T
EXPRESSION	IH K S P R EH SH AH N
F	EH F
FACTOR	F AE K T ER
FARMING	F AA R M IH NG
FED	F EH D
FERMENTATION	F ER M AH N T EY SH AH N
FERMENTER	F ER M EH N T ER
FERMENTORS	F ER M EH N T ER Z
FINGER	F IH NG G ER
FINGERPRINTING	F IH NG G ER P R IH N T IH NG
FINITE	F AY N AY T
FISH	F IH SH
FLASK	F L AE S K
FLAVOUR	F L AE V AH R
FLAVR	F L AE V R
FLUORESCENCE	F L UH R EH S AH N S
FOCUSSING	F OW K AH S IH NG
FORCES	F AO R S IH Z
FREE	F R IY
FRUIT	F R UW T
FUNCTIONAL	F AH NG K SH AH N AH L
FUNGI	F AH N JH AY
FUSION	F Y UW ZH AH N
FUSOGEN	F Y UW S AH JH AH N
G	JH IY
GAMETOCLONAL	G AE M AH T AA K L AH N AH L
GAMMA	G AE M AH
GAY	G EY
GEL	JH EH L
GENE	JH IY N
GENERATION	JH EH N ER EY SH AH N
GENES	JH IY N Z
GENETIC	JH AH N EH T IH K
GENOME	JH IY N OW M
GENOMIC	JH EH N AH M AH K
GENOMICS	JH IY N OW M IH K S
GENSCAN	JH EH N S AH N
GEORGE	JH AO R JH
GERMPLASM	JH ER M P L AE Z AH M
GLUCOSE	G L UW K OW S
GLUTAMYL	G L UW T AH M AH L
GLUTATHIONE	G L UW T AE TH IY OW N
GLYCINE	G L AY S IY N
GLYCINE(2)	G L AY S AH N
GOLDEN	G OW L D AH N
GOOD	G UH D
GOOD(2)	G IH D
GROWTH	G R OW TH
GUN	G AH N
H	EY CH
HAPLOIDS	HH AE P L OY D Z
HELA	HH EH L AH
HERBICIDE	HH ER B IH S AY D
HERBICIDE(2)	ER B IH S AY D
HETEROKARYONS	HH EH T AH R AH K AE R AY AH N Z
HETEROLOGOUS	HH EH T AH R AA L AH G AH S
HEXOKINASE	HH EH K S AA K AH N EY Z
HIGH	HH AY
HOMOGENATION	HH OW M AA JH AH N EY SH AH N
HOMOLOGENE	HH AH M AA L AH JH IY N
HOST	HH OW S T
HUMAN	HH Y UW M AH N
HUMAN(2)	Y UW M AH N
HUMULIN	HH Y UW M Y UW L IH N
HYBRIDISATION	HH AY B R AH D IY Z EY SH AH N
HYBRIDIZATION	HH AY B R AH D AH Z EY SH AH N
HYBRIDOMA	HH IH B R IH D AH M AH
HYBRIDS	HH AY B R AH D Z
HYDROGEN	HH AY D R AH JH AH N
HYDROPHOBIC	HH AY D R AH F OW B IH K
I	AY
IMMUNOSORBENT	IH M Y UW N AH S AO R B AH N T
IN	IH N
INACTIVATION	IH N AE K T IH V EY SH AH N
INCLUSION	IH N K L UW ZH AH N
INCUBATOR	IH NG K Y AH B EY T ER
INHIBITION	IH N HH AH B IH SH AH N
INHIBITION(2)	IH N AH B IH SH AH N
INSERTIONAL	IH N S ER SH AH N AH L
INTERACTION	IH N T ER AE K SH AH N
INTERACTION(2)	IH N ER AE K SH AH N
INTERFERON	IH N T ER F EH R AA N
INTERFERON(2)	IH N T ER F IH R AA N
INTERLEUKINS	IH N T AH R L UW K AH N Z
INVERTED	IH N V ER T IH D
INVITRO	IH N V IH T R OW
IONIC	AY AA N IH K
IONISATION	AY AA N IY Z EY SH AH N
ISO	IH S OW
ISOELECTRIC	AH S OW AH L AH K T R AH K
ISOLATION	AY S AH L EY SH AH N
ISOMERASE	AH S AA M AH R EY Z
JAMES	JH EY M Z
JONES	JH OW N Z
K	K EY
KAPPA	K AE P AH
KNOCK	N AA K
KOHLER	K OW L ER
L	EH L
LABORATORY	L AE B R AH T AO R IY
LARKIN	L AA R K IH N
LASER	L EY Z ER
LEUKEMIA	L UW K IY M IY AH
LIBRARY	L AY B R EH R IY
LINES	L AY N Z
LINKED	L IH NG K T
LIPOFECTION	L IH P AH F EH K AH N
LIPOSOMES	L IH P AH S OW M Z
LIQUID	L IH K W AH D
LIQUID(2)	L IH K W IH D
LYMPHOCYTES	L IH M F AH S AY T S
LYOPHILISATION	L AY AH F AY L AH S EY SH AH N
M	EH M
MALDI	M AE L D IY
MALE	M EY L
MAP	M AE P
MAPPING	M AE P IH NG
MAPS	M AE P S
MARK	M AA R K
MARKER	M AA R K ER
MASS	M AE S
MATRIX	M EY T R IH K S
MEASURE	M EH ZH ER
MEDIA	M IY D IY AH
MEDIATED	M IY D IY EY T IH D
MEDIUM	M IY D IY AH M
MERISTEM	M AH R IH S T AH M
METABOLIC	M EH T AH B AA L IH K
METABOLITE	M AH T AE B AH L AY T
METABOLITES	M AH T AE B AH L AY T S
METAGENOME	M AH T AE JH AH N OW M
METAGENOMICS	M EH T AH JH EH N AH M AH S Z
MICRO	M AY K R OW
MICROARRAY	M AY K R OW AH R EY
MICROBIAL	M AY K R OW B IY AH L
MICROBIOLOGICAL	M AY K R OW B AY AH L AA JH IH K AH L
MICROINJECTION	M AY K R OW IH N JH EH K SH AH N
MICROSCOPE	M AY K R AH S K OW P
MILESTEIN	M AY L S T AY N
MOLECULAR	M AH L EH K Y AH L ER
MONOCLONAL	M AA N AH K L OW N AH L
MOUSE	M AW S
MULTIPLE	M AH L T AH P AH L
MULTIPOTENT	M AH L T AY P OW T AH N T
MUTAGENESIS	M Y UW T AH JH IY N AH S AH S
MUTATION	M Y UW T EY SH AH N
MYELOMA	M AY EH L AH M AH
MYLOGENOUS	M AH L AA JH AH N AH S
N	EH N
NEUTRACEUTICAL	N Y UW T R AH S AH Y AH T IH S AH L
NICK	N IH K
NITROGEN	N AY T R AH JH AH N
NON	N AA N
NORTHERN	N AO R DH ER N
NUCLEASE	N AH K L IY Z
NUCLEOTIDE	N UW K L IY AH T AY D
NUTRIENT	N UW T R IY AH N T
NUTRITIVE	N UW T R AH T IH V
O	OW
OF	AH V
OLIGO	AA L AH G OW
ON	AA N
ON(2)	AO N
ONCOGENE	AA NG K OW JH IY N
OR	AO R
OR(2)	ER
ORGAN	AO R G AH N
ORGANELLE	AO R G AH N AH L
ORGANOGENESIS	AO R G AH N OW JH EH N AH S IH S
OSMOLALITY	AA S M OW L AH L AH T IY
OUT	AW T
OUTS	AW T S
OXYGEN	AA K S AH JH AH N
OXYGEN(2)	AA K S IH JH AH N
P	P IY
PAGE	P EY JH
PALI	P AE L IY
PAM	P AE M
PARALOGS	P AA R AH L AA G Z
PARASEXUAL	P AA R AH S EH K SH AH W AH L
PARTITION	P AA R T IH SH AH N
PASTORIS	P AE S T ER IY Z
PEPTIDE	P EH P T AY D
PEST	P EH S T
PHARMING	F AA R M AH NG
PHASE	F EY Z
PHILADELPHIA	F IH L AH D EH L F IY AH
PHOSPHATASE	F AA S AH T EY Z
PHYTOALEXINS	F IH T AH L EH K S AH N Z
PICHIA	P IH CH IY AH
PILOT	P AY L AH T
PLANT	P L AE N T
PLANTS	P L AE N T S
PLASMID	P L AE Z AH M AH D
PLASMINOGEN	P L AE Z M IH N AH JH IH N
PLASTICS	P L AE S T IH K S
PLATING	P L EY T IH NG
PLEURIPOTENT	P L AH R IH P AH T AH N T
POINT	P OY N T
POLYCLONAL	P AH L IH K L AH N AH L
POLYLINKER	P OW L IY L IH NG K ER
POLYMERASE	P AA L IH M ER EY S
POLYMORPHISM	P AA L IY M AO R F IH Z M
POMATO	P AA M AH T OW
POSITIVE	P AA Z AH T IH V
POTENT	P OW T AH N T
PRACTICES	P R AE K T IH S IH Z
PREDICTION	P R IY D IH K SH AH N
PRESERVATION	P R EH Z ER V EY SH AH N
PRIMARY	P R AY M EH R IY
PRIMER	P R AY M ER
PRINTING	P R IH N T IH NG
PRINTING(2)	P R IH N IH NG
PRIONS	P R AY AH N Z
PRO	P R OW
PROBE	P R OW B
PROCESSING	P R AA S EH S IH NG
PROFILE	P R OW F AY L
PROJECT	P R AA JH EH K T
PROPAGATION	P R AA P AH G EY SH AH N
PROTEIN	P R OW T IY N
PROTEINS	P R OW T IY N Z
PROTEOME	P R OW T IY OW M
PROTEOMICS	P R OW T IY AH M AH S Z
PROTOPLAST	P R OW T AA P L AE S T
QUARTERNARY	K W AO R T AH R N EH R IY
QUININE	K W AY N AY N
R	AA R
RANDOM	R AE N D AH M
RATE	R EY T
REACTION	R IY AE K SH AH N
RECOMBINANT	R IH K AA M B IH N AH N T
REFERENCE	R EH F ER AH N S
REFERENCE(2)	R EH F R AH N S
RELAY	R IY L EY
REPLICA	R EH P L IH K AH
RESCUE	R EH S K Y UW
RESISTANCE	R IH Z IH S T AH N S
RESISTANCE(2)	R IY Z IH S T AH N S
RESTRICTION	R IY S T R IH K SH AH N
RETRIEVAL	R IH T R IY V AH L
RETRIEVAL(2)	R IY T R IY V AH L
REVERSE	R IH V ER S
REVERSE(2)	R IY V ER S
RICE	R AY S
RIPENING	R AY P AH N IH NG
RIPENING(2)	R AY P N IH NG
ROLLER	R OW L ER
ROUND	R AW N D
ROUS	R OW AH S
S	EH S
SALT	S AO L T
SAVER	S EY V ER
SAVR	S EY V ER
SCALE	S K EY L
SCOWCROFT	S K OW K R AO F T
SCREENING	S K R IY N IH NG
SECONDARY	S EH K AH N D EH R IY
SEED	S IY D
SELECTION	S AH L EH K SH AH N
SEQUENCE	S IY K W AH N S
SEQUENCING	S IY K W AH N S IH NG
SERUM	S IH R AH M
SHIKONIN	SH IH K AH N AH N
SHOT	SH AA T
SHOTGUN	SH AA T G AH N
SHUTTLE	SH AH T AH L
SINGLE	S IH NG G AH L
SITE	S AY T
SITU	S IH T UW
SOMACLONAL	S AH M AE K L AH N AH L
SOMATIC	S OW M AE T IH K
SOUTHERN	S AH DH ER N
SPARGER	S P AA R JH ER
SPECIFIC	S P AH S IH F IH K
SPECIFIC(2)	S P IH S IH F IH K
SPECTROMETER	S P EH K T R AA M AH T ER
SPECTROMETRY	S P EH K T R AA M AH T R IY
SPINNER	S P IH N ER
STEM	S T EH M
STERILITY	S T ER IH L IH T IY
STIRRED	S T ER D
STORAGE	S T AO R AH JH
STORAGE(2)	S T AO R IH JH
STRAIN	S T R EY N
STRATEGY	S T R AE T AH JH IY
STRESS	S T R EH S
STRUCTURAL	S T R AH K CH ER AH L
STRUCTURE	S T R AH K CH ER
SUB	S AH B
SUSPENSION	S AH S P EH N SH AH N
SYSTEM	S IH S T AH M
T	T IY
TAGS	T AE G Z
TANK	T AE NG K
TAXOL	T AE K S AA L
TAXONOMY	T AE K S AA N AH M IY
TECHNIQUE	T EH K N IY K
TECHNOLOGY	T EH K N AA L AH JH IY
TERTIARY	T ER SH ER IY
TERTIARY(2)	T ER SH IY EH R IY
THALASSAEMIA	TH AE L AH S IY M IY AH
THERAPEUTIC	TH EH R AH P Y UW T IH K
THERAPY	TH EH R AH P IY
THOMSON	T AA M S AH N
THROUGHPUT	TH R UW P UH T
THURINGIENSIS	TH UH R AH N JH IY N S AH S
TI	T IY
TIME	T AY M
TISSUE	T IH S Y UW
TISSUE(2)	T IH SH UW
TO	T UW
TO(2)	T IH
TO(3)	T AH
TOLERANCE	T AA L ER AH N S
TOOLS	T UW L Z
TOTIPOTENT	T AH T IH P AH T AH N T
TRANSCRIPTASE	T R AE N S R IH P T EY Z
TRANSFECTION	T R AE N S F EH K SH AH N
TRANSFER	T R AE N S F ER
TRANSFORMATION	T R AE N S F ER M EY SH AH N
TRANSGENE	T R AE N S JH IY N
TRANSGENIC	T R AE N Z JH EH N IH K
TRANSLATION	T R AE N Z L EY SH AH N
TRANSLATION(2)	T R AE N S L EY SH AH N
TRANSPLANTATION	T R AE N Z P L AE N T EY SH AH N
TRIAD	T R AY AE D
TRIPLOIDS	T R IH P L OY D Z
TUMEFACIENS	T Y UW M EH F AH S IY N Z
TURBIDOSTAT	T AH R B AH D AA S T AH T
TWO	T UW
U	Y UW
UNI	Y UW N IY
UNIGENE	Y UW N IH JH IY N
UNIPROT	Y UW N AH P R AA T
UP	AH P
UPTAKE	AH P T EY K
V	V IY
VACCINES	V AE K S IY N Z
VALUE	V AE L Y UW
VAN	V AE N
VARIATION	V EH R IY EY SH AH N
VECTORS	V EH K T ER Z
VIRUS	V AY R AH S
VITRO	V IH T R OW
VITRO(2)	V IY T R OW
VIVO	V IY V OW
WAALS	W AA L Z
WAYS	W EY Z
WHITE	W AY T
WHITE(2)	HH W AY T
WHOLE	HH OW L
XENOBIOTICS	Z EH N AH B IY AH T AH S Z
Y	W AY
YEAST	Y IY S T
ZYMOGENS	Z IH M AH JH AH N Z
VECTOR	V EH K T ER
MOLECULAR 	M AH L EH K Y AH L ER
PHARMING F AA R M IH NG
*
6	S IH K S
A	AH
A(2)	EY
ABSORPTION	AH B Z AO R P SH AH N
ABSORPTION(2)	AH B S AO R P SH AH N
ACHIRAL	AE CH AH R AH L
ACID	AE S AH D
ACIDITY	AH S IH D AH T IY
ACIDS	AE S AH D Z
ACTINOID	AE K T AH N OY D
ACTINOIDS	AE K T AH N OY D Z
ACTION	AE K SH AH N
ACTIVATED	AE K T IH V EY T IH D
ACTIVATION	AE K T AH V EY SH AH N
ACTIVATORS	AE K T IH V AH T ER Z
ACTIVE	AE K T IH V
ACYLATION	EY S IY L EY SH AH N
ADDITION	AH D IH SH AH N
ADDUCT	AE D AH K T
ADSORPTION	AE D S AO R P AH N
AGENTS	EY JH AH N T S
ALCOHOL	AE L K AH HH AA L
ALCOHOLS	AE L K AH HH AO L Z
ALDEHYDES	AE L D AH HH AY D Z
ALDOL	AE L D AH L
ALDOPENTOSE	AE L D AA P AH N T OW Z
ALKANAMINES	AE L K AE N AH M AY N Z
ALKENES	AE L K IY N Z
ALKYL	AE L K AH L
ALKYLATION	AE L K AH L EY SH AH N
ALKYLBENZENES	AE L K IH L B AH N Z IY N Z
ALKYNES	AE L K AY N Z
ALLOSTERIC	AE L AA S T AH R AH K
ALLOTROPIC	AH L AA T R OW P IH K
ALLYLIC	AE L AH L AH K
AMBIDENT	AE M B AH D AH N T
AMBIDENTATE	AE M B IH D AH N T EY T
AMINES	AH M AY N Z
AMINO	AH M IY N OW
AMMONOLYSIS	AE M AH N AA L AH S AH S
AMORPHOUS	AH M AO R F AH S
AMYLOPECTIN	AE M AH L AH P EH K T AH N
AMYLOSE	AE M AH L OW Z
ANALGESICS	AE N AH L JH IY Z IH K S
ANHYDRIDES	AE N HH AH D R AY D Z
ANIMAL	AE N AH M AH L
ANIONIC	AE N AY AA N IH K
ANISOTROPIC	AE N AH S AA T R AH P AH K
ANOMALOUS	AH N AA M AH L AH S
ANOMERS	AE N AH M AH R Z
ANTACIDS	AE N T AE S AH D Z
ANTIBIOTICS	AE N T IY B AY AA T IH K S
ANTIBIOTICS(2)	AE N T AY B AY AA T IH K S
ANTIDEPRESSANT	AE N T IY D IH P R EH S AH N T
ANTIFERROMAGNETISM	AE N T AY F EH R OW M AE G N AH T IH Z AH M
ANTIFERTILITY	AE N T AY F ER T IH L AH T IY
ANTIHISTAMINES	AE N T IY HH IH S T AH M AH N Z
ANTIMICROBIAL	AE N T AY M AY K R OW B IY AH L
ANTIPYRETIC	AE N T AH P IH R AH T AH K
ANTISEPTICS	AE N T AH S EH P T IH K S
AQUA	AE K W AH
AQUA(2)	AA K W AH
ARC	AA R K
ARKEL	AA R K AH L
AROMATIC	EH R AH M AE T IH K
ARRHENIUS	AE R EH N AY AH S
ARTIFICIAL	AA R T AH F IH SH AH L
ARYL	AE R AH L
ARYLAMINES	AH R IH L AH M AY N Z
ASPIRIN	AE S P R IH N
ASYMMETRIC	EY S AH M EH T R IH K
ASYMMETRY	EY S IH M AH T R IY
ATOMIC	AH T AA M IH K
AVERAGE	AE V ER IH JH
AVERAGE(2)	AE V R IH JH
AVOGADRO	AE V AH G AE D R OW
AZEOTROPE	EY Z IY AH T R OW P
AZO	AE Z OW
B	B IY
BACTERICIDAL	B AE K T AH R IH S AH D AH L
BACTERIOSTATIC	B AE K T IY R IY AA S T AH T AH K
BAEYERS	B IY AY AH R Z
BAKELITE	B AE K AH L AY T
BARBITURATES	B AA R B IH CH ER AH T S
BASES	B EY S AH Z
BASES(2)	B EY S IH Z
BASES(3)	B EY S IY Z
BASICITY	B EY S IH K S AH T IY
BATTERIES	B AE T ER IY Z
BATTERY	B AE T ER IY
BEHAVIOUR	B IH HH EY V Y ER
BENZYLIC	B IH N Z AY L AH K
BIMOLECULAR	B AY M AH L EH K Y AH L ER
BINARY	B AY N AH R IY
BIOCHEMICAL	B AY OW K EH M IH K AH L
BIODEGRADABLE	B AY OW D AH G R EY D AH B AH L
BIOMOLECULES	B AY AH M AA L AH K Y UW L Z
BLACK	B L AE K
BLAST	B L AE S T
BLISTER	B L IH S T ER
BLOCK	B L AA K
BODY	B AA D IY
BOHR	B AO R
BOND	B AA N D
BONDED	B AA N D AH D
BONDED(2)	B AA N D IH D
BONDING	B AA N D IH NG
BRANCHED	B R AE N CH T
BRAVAIS	B R AE V EY AH S
BREDIGS	B R EH D AH G Z
BRIDGE	B R IH JH
BROAD	B R AO D
BROMAMIDE	B R AA M AH M AY D
BROWN	B R AW N
BROWNIAN	B R OW N IY AH N
BUNA	B Y UW N AH
CALCINATION	K AE L S AH N EY SH AH N
CANNIZZARO	K AA N IY T S AA R OW
CARBOCATION	K AA R B AH K EY SH AH N
CARBOHYDRATES	K AA R B OW HH AY D R EY T S
CARBON	K AA R B AH N
CARBONYLS	K AA R B AH N IH L Z
CARBYLAMINE	K AA R B IH L AH M AY N
CAST	K AE S T
CATALYSIS	K EY T AH L IY Z IY Z
CATALYST	K AE T AH L IH S T
CATALYTIC	K AE T AH L IH T IH K
CATIONIC	K EY SH AH N IH K
CELLULOSE	S EH L Y AH L OW S
CENTRE	S EH N T ER
CENTRED	S EH N T ER D
CHAIN	CH EY N
CHATELIERS	CH AE T AH L IY R Z
CHELATE	CH IY L EY T
CHEMICAL	K EH M IH K AH L
CHEMISORPTION	K EH M AH S AO R P AH N
CHEMISTRY	K EH M IH S T R IY
CHEMOTHERAPY	K IY M OW TH EH R AH P IY
CHIRAL	CH AY R AH L
CHIRALITY	CH AH R AE L AH T IY
CHROMATOGRAPHIC	K R OW M AE T AH G R AE F IH K
CHROMATOGRAPHY	K R OW M AH T AA G R AH F IY
CIS	S IH Z
CLASSIFICATION	K L AE S AH F AH K EY SH AH N
CLEANSING	K L EH N Z IH NG
CLEMMENSEN	K L EH M AH N S EH N
CLOSE	K L OW S
CLOSE(2)	K L OW Z
COAGULATION	K OW AE G Y AH L EY SH AH N
COLLIGATIVE	K AA L AH G EY T AH V
COLLISION	K AH L IH ZH AH N
COLLOIDS	K AA L OY D Z
COLUMN	K AA L AH M
COMPETITIVE	K AH M P EH T AH T IH V
COMPETITIVE(2)	K AH M P EH T IH T IH V
COMPLEX	K AA M P L EH K S
COMPLEX(2)	K AH M P L EH K S
COMPOUNDS	K AA M P AW N D Z
COMPOUNDS(2)	K AH M P AW N D Z
CONCENTRATION	K AA N S AH N T R EY SH AH N
CONDENSATION	K AA N D AH N S EY SH AH N
CONDUCTANCE	K AA N D AH K T AH N S
CONDUCTIVITY	K AA N D AH K T IH V AH T IY
CONDUCTORS	K AH N D AH K T ER Z
CONE	K OW N
CONFIGURATION	K AH N F IH G Y ER EY SH AH N
CONSTANT	K AA N S T AH N T
CONTRACTION	K AH N T R AE K SH AH N
COOLED	K UW L D
COORDINATION	K OW AO R D AH N EY SH AH N
COPOLYMERISATION	K OW P AA L AH M ER IY Z EY SH AH N
COPOLYMERS	K OW P AA L AH M ER Z
COPPER	K AA P ER
CORROSION	K ER OW ZH AH N
COUPLES	K AH P AH L Z
CRAFTS	K R AE F T S
CRAFTS(2)	K R AE F S
CROSS	K R AO S
CRYOSCOPIC	K R AY AA S K OW P IH K
CRYSTAL	K R IH S T AH L
CRYSTALLINE	K R IH S T AH L AY N
CUMENE	K Y UW M IY N
CYCLIC	S AY K L IH K
D	D IY
DALTONS	D AO L T AH N Z
DANIELL	D AE N IY L
DEFECT	D IY F EH K T
DEFECT(2)	D IH F EH K T
DEFECTS	D IY F EH K T S
DEFECTS(2)	D IH F EH K T S
DEHYDROGENATION	D IY HH AY D R AH JH AH N EY SH AH N
DENATURATION	D IY N EY CH ER EY SH AH N
DENSITY	D EH N S AH T IY
DENSITY(2)	D EH N S IH T IY
DENTICITY	D EH N T IH K SH AH T IY
DEOXYRIBONUCLEIC	D IY AA K S IY R AY B OW N UW K L EY IH K
DEOXYRIBOSE	D IY AA K S IH R AH B OW Z
DEPENDENCE	D IH P EH N D AH N S
DEPRESSANTS	D IH P R EH S AH N T S
DER	D ER
DETERGENTS	D IH T ER JH AH N T S
DEXTROROTATORY	D IH Z T R AO R AH T AH T AO R IY
DIAGRAM	D AY AH G R AE M
DIALYSER	D AY AH L IY Z ER
DIALYSIS	D AY AE L AH S AH S
DIALYSIS(2)	D AY AE L IH S IH S
DIAMAGNETISM	D AY AH M AE G N IH T IH Z AH M
DIAZONIUM	D AY AH Z OW N IY AH M
DIAZOTISATION	D AY AH Z AA T AH S EY SH AH N
DIDENTATE	D IH D AH N T AH T
DIODE	D AY OW D
DISACCHARIDES	D AH S AE K AH R AY D Z
DISINFECTANTS	D IH S IH N F EH K T AH N T S
DISLOCATION	D IH S L OW K EY SH AH N
DISPERSED	D IH S P ER S T
DISPERSION	D IH S P ER ZH AH N
DISSOCIATION	D IH S OW S IY EY SH AH N
DISTILLATION	D IH S T AH L EY SH AH N
DONATING	D OW N EY T IH NG
DRUG	D R AH G
DRUGS	D R AH G Z
DYES	D AY Z
EBULLIOSCOPIC	AH B UH L IY AA S AH P AH K
EFFECT	IH F EH K T
EFFECT(2)	IY F EH K T
EFFECT(3)	AH F EH K T
EFFICIENCY	IH F IH SH AH N S IY
ELASTOMERS	IH L AE S T AH M ER Z
ELECTRICAL	IH L EH K T R IH K AH L
ELECTRO	IH L EH K T R OW
ELECTROCHEMICAL	AH L EH K T R OW K EH M IH K AH L
ELECTROCHEMISTRY	AH L EH K T R AA K AH M IH S T R IY
ELECTRODE	IH L EH K T R OW D
ELECTROLYSIS	EH L EH K T R AA L AH S IH S
ELECTROLYTES	AH L EH K T R AH L AY T S
ELECTROLYTIC	IH L EH K T R AH L IH T IH K
ELECTROMOTIVE	AH L EH K T R AA M AH T AH V
ELECTRON	IH L EH K T R AA N
ELECTRONEGATIVITY	AH L EH K T R AA N AH G AH T IH V AH T IY
ELECTRONIC	IH L EH K T R AA N IH K
ELECTROOSMOSIS	AH L EH K T R UW Z M OW S AH S
ELECTROPHILIC	AH L EH K T R AH F AY L AH K
ELECTROSTATIC	IH L EH K T R OW S T AE T IH K
ELEMENTS	EH L AH M AH N T S
ELEVATION	EH L AH V EY SH AH N
ELIMINATION	IH L IH M AH N EY SH AH N
ELLINGHAM	EH L IH NG HH AE M
ELUANT	AH L UW W AH N T
EMPIRICAL	EH M P IH R IH K AH L
EMULSIFIERS	IH M AH L S AH F AY ER Z
EMULSIONS	IH M AH L SH AH N Z
ENANTIOMERS	AH N AH N T AY AA M AH R Z
END	EH N D
ENERGY	EH N ER JH IY
ENTHALPY	EH N TH AE L P IY
ENTITY	EH N T AH T IY
ENTITY(2)	EH N T IH T IY
ENVIRONMENTAL	IH N V AY R AH N M EH N T AH L
ENVIRONMENTAL(2)	IH N V AY R AH N M EH N AH L
ENZYME	EH N Z AY M
ENZYMES	EH N Z AY M Z
EQUATION	IH K W EY ZH AH N
EQUILIBRIUM	IY K W AH L IH B R IY AH M
ESTERIFICATION	EH S T ER AH F AH K EY SH AH N
ESTERS	EH S T ER Z
ETARD	EH T AH R D
ETHERS	IY TH ER Z
EXCESS	EH K S EH S
EXCESS(2)	IH K S EH S
FACE	F EY S
FACIAL	F EY SH AH L
FACTOR	F AE K T ER
FARADAYS	F AA R AH D EY Z
FAT	F AE T
FATTY	F AE T IY
FEHLINGS	F EH L AH NG Z
FERRIMAGNETISM	F EH R AH M AE G N AH T IH Z AH M
FERROMAGNETISM	F EH R OW M AE G N AH T IH Z AH M
FIBRES	F AY B AH R Z
FIBROUS	F AY B R AH S
FIELD	F IY L D
FINKELSTEIN	F IH NG K AH L S T IY N
FINKELSTEIN(2)	F IH NG K AH L S T AY N
FIRST	F ER S T
FITTIG	F IH T AH G
FLOATATION	F L OW T EY SH AH N
FORCE	F AO R S
FORCES	F AO R S IH Z
FORMALDEHYDE	F AO R M AE L D AH HH AY D
FORMALDEHYDE(2)	F ER M AE L D AH HH AY D
FORMS	F AO R M Z
FORMULA	F AO R M Y AH L AH
FRACTION	F R AE K SH AH N
FRACTIONAL	F R AE K SH AH N AH L
FREE	F R IY
FRENKEL	F R EH NG K AH L
FREON	F R IY AA N
FREQUENCY	F R IY K W AH N S IY
FREUNDLICH	F R OY N D L IH K
FRIEDEL	F R IY D AH L
FROTH	F R AO TH
FRUCTOSE	F R AH K T OW S
FUEL	F Y UW AH L
FUEL(2)	F Y UW L
FURANOSE	F ER AH N OW Z
FURNACE	F ER N AH S
GABRIEL	G EY B R IY AH L
GALVANIC	G AE L V AE N IH K
GANGUE	G AE NG
GASES	G AE S AH Z
GASES(2)	G AE S IH Z
GATTERMAN	G AE T AH R M AH N
GELS	JH EH L Z
GEMINAL	JH EH M IH N AH L
GEOMETRIC	JH IY AH M EH T R IH K
GIANT	JH AY AH N T
GIBBS	G IH B Z
GLOBULAR	G L AA B Y AH L ER
GLUCONIC	G L UW K AH N AH K
GLUCOSE	G L UW K OW S
GLYCERALDEHYDE	G L AH S AH R AE L D AH HH AY D
GLYCOGEN	G L AY K AH JH IH N
GLYCOSIDIC	G L AY K AH S AY D IH K
GRIGNARD	G R IH G N AH R D
GROUP	G R UW P
H	EY CH
HABERS	HH AE B AH R Z
HALF	HH AE F
HALIDES	HH AE L AY D Z
HALL	HH AO L
HALOALKANE	HH AE L OW L K EY N
HALOARENE	HH AE L AH R IY N
HALOGENATION	HH AE L AH JH AH N EY SH AH N
HALOGENS	HH AE L AH JH AH N Z
HAWORTH	HH AE W ER TH
HELL	HH EH L
HEMIACETAL	HH IY M IY AE S AH T AH L
HENRYS	HH EH N R IY Z
HEROULT	HH AH R OW L T
HETEROCYCLIC	HH AH T EH R AH S AH K L AH K
HETEROGENEOUS	HH EH T ER AH JH IY N Y AH S
HETEROLEPTIC	HH AH T EH R AH L AH P T AH K
HIGH	HH AY
HINSBERGS	HH IH N S B AH R G Z
HISTAMINES	HH IH S T AH M AY N Z
HOFFMANN	HH AO F M AH N
HOLE	HH OW L
HOLMES	HH OW M Z
HOLMES(2)	HH OW L M Z
HOMOGENEOUS	HH OW M AH JH IY N IY AH S
HOMOLEPTIC	HH AA M AH L AH P T AH K
HYBRIDISATION	HH AY B R AH D IY Z EY SH AH N
HYDRATE	HH AY D R EY T
HYDRATION	HH AY D R EY SH AH N
HYDRAULIC	HH AY D R AO L IH K
HYDRO	HH AY D R OW
HYDROBORATION	HH IH D R AA B AH R EY SH AH N
HYDROGEN	HH AY D R AH JH AH N
HYPERACIDITY	HH AY P ER AH S IH D AH T IY
IDEAL	AY D IY L
IMPURITY	IH M P Y UH R AH T IY
IN	IH N
INACTIVE	IH N AE K T IH V
INHIBITORS	IH N HH IH B AH T ER Z
INITIATING	IH N IH SH IY EY T IH NG
INNER	IH N ER
INSTABILITY	IH N S T AH B IH L IH T IY
INSTANTANEOUS	IH N S T AH N T AE N IY AH S
INSULATORS	IH N S AH L EY T ER Z
INTER	IH N T ER
INTERACTION	IH N T ER AE K SH AH N
INTERACTION(2)	IH N ER AE K SH AH N
INTERMOLECULAR	IH N T ER M AH L EH K Y AH L ER
INTERSTITIAL	IH N T ER S T IH SH AH L
INTRAMOLECULAR	IH N T R AH M AH L EH K Y AH L ER
INTRINSIC	IH N T R IH N S IH K
INVERSION	IH N V ER ZH AH N
INVERT	IH N V ER T
ION	AY AA N
ION(2)	AY AH N
IONIC	AY AA N IH K
IONISATION	AY AA N IY Z EY SH AH N
IRON	AY ER N
ISOMER	AY S AH M ER
ISOMERISM	AY S AH M ER IH Z AH M
ISOTHERM	IH S AH TH AH R M
ISOTONIC	AY S AH T AA N IH K
KETONES	K AH T OW N Z
KINETIC	K AH N EH T IH K
KINETIC(2)	K IH N EH T IH K
KINETICS	K AH N EH T IH K S
KISHNER	K IH SH N AH R
KOCH	K AO CH
KOCH(2)	K OW K
KOHLRAUSCH	K OW L R AH S
KOLBE	K OW L B
KOLBES	K OW L B Z
KRAFT	K R AE F T
LACTOSE	L AE K T OW S
LAEVOROTATORY	L IY V AO R AH T AH T AO R IY
LANTHANIDE	L AE N TH AH N AY D
LANTHANOIDS	L AE N TH AH N OY D Z
LATTICE	L AE T AH S
LATTICES	L AE T AH S IH Z
LAUNDRY	L AO N D R IY
LAW	L AO
LAW(2)	L AA
LE	L AH
LEACHING	L IY CH IH NG
LEWIS	L UW IH S
LIFE	L AY F
LIGAND	L IH G AH N D
LIGANDS	L IH G AH N D Z
LIMITED	L IH M AH T AH D
LIMITED(2)	L IH M IH T IH D
LINE	L AY N
LINEAR	L IH N IY ER
LINKAGE	L IH NG K AH JH
LINKAGE(2)	L IH NG K IH JH
LINKED	L IH NG K T
LIQUATION	L IH K W EY SH AH N
LIQUIDS	L IH K W AH D Z
LIQUIDS(2)	L IH K W IH D Z
LONG	L AO NG
LOW	L OW
LUCAS	L UW K AH S
LYOPHILIC	L AY AH F AY L AH K
LYOPHOBIC	L AY AH F AH B AH K
MAGNETIC	M AE G N EH T IH K
MAGNETON	M AE G N AH T AO N
MALTASE	M AO L T EY S
MALTOSE	M AO L T OW S
MARKOVNIKOVS	M AA R K AA V N AH K AH V Z
MATTE	M AE T
MECHANISM	M EH K AH N IH Z AH M
MEDICATED	M EH D IH K EY T IH D
MEDIUM	M IY D IY AH M
MELAMINE	M EH L AH M IY N
MEMBRANE	M EH M B R EY N
MERIDIONAL	M IH ER AH D IY AH N AH L
MESSENGER	M EH S AH N JH ER
MESSENGER(2)	M EH S IH N JH ER
MESSENGERS	M EH S AH N JH ER Z
METAL	M EH T AH L
METALLIC	M AH T AE L IH K
METALLURGY	M EH T AH L ER JH IY
METALS	M EH T AH L Z
METHOD	M EH TH AH D
METHODS	M EH TH AH D Z
MICELLES	M AY S EH L Z
MINERALS	M IH N ER AH L Z
MINERALS(2)	M IH N R AH L Z
MISCHMETALL	M IH S M EH T AH L
MIXTURE	M IH K S CH ER
MOLAL	M OW L AH L
MOLALITY	M OW L AH L AH T IY
MOLAR	M OW L ER
MOLARITY	M OW L ER AH T IY
MOLE	M OW L
MOLECULAR	M AH L EH K Y AH L ER
MOLECULARITY	M AH L EH K Y AH L ER AH T IY
MOLECULES	M AA L AH K Y UW L Z
MOND	M AA N D
MONOCLINIC	M AA N AH K L IH N IH K
MONONUCLEAR	M AA N AH N UW K L IY ER
MONOSACCHARIDES	M AH N AH S AE K AH R AY D Z
MOVEMENT	M UW V M AH N T
N	EH N
NARCOTIC	N AA R K AA T IH K
NARROW	N EH R OW
NARROW(2)	N AE R OW
NATTA	N AE T AH
NATURAL	N AE CH ER AH L
NATURAL(2)	N AE CH R AH L
NEOPRENE	N IY AH P R IY N
NEOPRENE(2)	N IY OW P R IY N
NERNST	N AH R N S T
NETWORK	N EH T W ER K
NITRATION	N AY T R EY SH AH N
NITROGEN	N AY T R AH JH AH N
NOBLE	N OW B AH L
NOMENCLATURE	N OW M AH N K L EY CH ER
NON	N AA N
NOVOLAC	N AA V AH L AH K
NUCLEIC	N UW K L EY IH K
NUCLEOPHILES	N AH K L IY AH F AY L Z
NUCLEOPHILIC	N AH K L IY AH F AY L AH K
NUCLEOSIDES	N AH K L IY AH S AY D Z
NUCLEOTIDES	N UW K L IY AH T AY D Z
NUMBER	N AH M B ER
NYLON	N AY L AA N
OCTAHEDRAL	AA K T AH HH IY D R AH L
OF	AH V
OLIGOSACCHARIDES	AH L AH G AH S AE K AH R AY D Z
ON	AA N
ON(2)	AO N
OPTICAL	AA P T IH K AH L
OPTICALLY	AA P T IH K L IY
ORBITAL	AO R B AH T AH L
ORDER	AO R D ER
ORES	AO R Z
ORGANO	AO R G AH N OW
OSMOSIS	AO Z M OW S IH S
OSMOTIC	AA Z M AA T AH K
OSTWALDS	AA S T W AH L D Z
OXIDATION	AA K S AH D EY SH AH N
OXIDES	AA K S AY D Z
OXIDOREDUCTASE	AA K S AH D AH R EH D AH K T EY Z
OXOACIDS	AA K S OW S AH D Z
OXYGEN	AA K S AH JH AH N
OXYGEN(2)	AA K S IH JH AH N
OZONE	OW Z OW N
OZONOLYSIS	AA Z AH N AA L AH S AH S
P	P IY
PACKED	P AE K T
PACKING	P AE K IH NG
PAPER	P EY P ER
PARAMAGNETISM	P AE R AH M AE G N AH T IH Z AH M
PEPTIDE	P EH P T AY D
PEPTIZATION	P EH P T AY Z EY SH AH N
PERMANGANATE	P AH R M AE N G AH N EY T
PHASE	F EY Z
PHENOLS	F EH N AH L Z
PHOSPHORUS	F AA S F ER AH S
PHTHALIMIDE	F TH AE L AH M AY D
PHYSISORPTION	F IH S AH S AO R P AH N
PIG	P IH G
POINT	P OY N T
POLAR	P OW L ER
POLARITY	P OW L EH R AH T IY
POLLUTION	P AH L UW SH AH N
POLYACRYLONITRILE	P AA L AY AE K R IH L AH N IH T R AH L
POLYAMIDES	P OW L IY AE M AY D Z
POLYDENTATE	P OW L IY D EH N T AH T
POLYESTERS	P AA L IY EH S T ER Z
POLYHEDRON	P AA L IY HH IY D R AH N
POLYHYDRIC	P AA L AH HH AH D R AH K
POLYMER	P AA L AH M ER
POLYMERISATION	P AA L AH M ER IY Z EY SH AH N
POLYMERS	P AA L IH M ER Z
POLYSACCHARIDES	P AA L IY S AE K ER AY D Z
POLYTHENE	P AA L AH TH IY N
POTENTIAL	P AH T EH N SH AH L
PRESERVATIVES	P R AH Z ER V AH T IH V Z
PRESSURE	P R EH SH ER
PRIMARY	P R AY M EH R IY
PRINCIPLE	P R IH N S AH P AH L
PROCESS	P R AA S EH S
PROCESS(2)	P R AO S EH S
PROPAGATING	P R AA P AH G EY T IH NG
PROPELLANTS	P R OW P EH L AH N T S
PROPERTIES	P R AA P ER T IY Z
PROTEIN	P R OW T IY N
PROTEINS	P R OW T IY N Z
PROTIC	P R AA T AH K
PSEUDO	S UW D OW
PURIFICATION	P Y UH R AH F AH K EY SH AH N
PYRANOSE	P IH R AH N OW Z
PYROMETALLURGY	P AH R AA M AH T AE L AH R JH IY
R	AA R
RACEMIC	R AE S AH M AH K
RACEMISATION	R EY S M IH S EY SH AH N
RADICAL	R AE D IH K AH L
RADII	R EY D IY AY
RANGE	R EY N JH
RAOULTS	R EY OW L T S
RATE	R EY T
REACTION	R IY AE K SH AH N
REACTIONS	R IY AE K SH AH N Z
REAGENT	R IY EY JH AH N T
REAGENT(2)	R IY JH AH N T
RECEPTORS	R AH S EH P T ER Z
RED	R EH D
REDOX	R EH D AA K S
REDUCING	R IH D UW S IH NG
REDUCTION	R IH D AH K SH AH N
REFINING	R AH F AY N IH NG
REFINING(2)	R IH F AY N IH NG
REFRIGERANT	R IH F R IH JH ER AH N T
REGIA	R AH JH AY AH
REIMER	R AY M ER
RELATIONSHIP	R IY L EY SH AH N SH IH P
RESINS	R EH Z AH N Z
RESINS(2)	R EH Z IH N Z
REVERBERATORY	R IH V ER B ER AH T OW R IY
REVERSE	R IH V ER S
REVERSE(2)	R IY V ER S
RHOMBIC	R AA M B AH K
RIBOSE	R AH B OW Z
RIBOSOMAL	R AH B AA S AH M AH L
RING	R IH NG
ROASTING	R OW S T IH NG
ROCHELLE	R OW SH EH L
ROCHELLE(2)	R AH SH EH L
ROSENMUND	R AH S EH N M AH N D
RUBBER	R AH B ER
RULE	R UW L
S	EH S
SACCHARIC	S AE K AH R AH K
SALT	S AO L T
SALTS	S AO L T S
SALVARSAN	S AE L V AA R Z AH N
SANDMAYERS	S AE N D M EY ER Z
SAPONIFICATION	S AH P AA N AH F AH K EY SH AH N
SCHOTTKY	SH AA T K IY
SCOURING	S K AW ER IH NG
SCREENS	S K R IY N Z
SECONDARY	S EH K AH N D EH R IY
SELECTIVE	S AH L EH K T IH V
SEMI	S EH M IY
SEMI(2)	S EH M AY
SEMICONDUCTORS	S EH M IY K AH N D AH K T ER Z
SEMICONDUCTORS(2)	S EH M IH K AH N D AH K T ER Z
SEMICONDUCTORS(3)	S EH M AY K AH N D AH K T ER Z
SEMIPERMEABLE	S EH M IY P ER M IY AH B AH L
SEPARATION	S EH P ER EY SH AH N
SHAPE	SH EY P
SHAVING	SH EY V IH NG
SHORT	SH AO R T
SIGNALS	S IH G N AH L Z
SITE	S AY T
SMOKE	S M OW K
SOAPS	S OW P S
SOLIDS	S AA L AH D Z
SOLS	S AA L Z
SOLUBILITY	S AA L AH B IH L AH T IY
SOLUBLE	S AA L Y AH B AH L
SOLUTION	S AH L UW SH AH N
SOLUTIONS	S AH L UW SH AH N Z
SOLVATE	S AA L V EY T
SOLVENTS	S AO L V AH N T S
SPECTRUM	S P EH K T R AH M
SPLITTING	S P L IH T IH NG
STARCH	S T AA R CH
STATE	S T EY T
STEP	S T EH P
STEPHEN	S T IY V AH N
STEREO	S T EH R IY OW
STOICHIOMETRIC	S T OY CH IY AH M AH T R AH K
STRONG	S T R AO NG
STRUCTURAL	S T R AH K CH ER AH L
STRUCTURE	S T R AH K CH ER
STRUCTURES	S T R AH K CH ER Z
SUBSTITUTION	S AH B S T IH T UW SH AH N
SUCROSE	S UW K R OW S
SUGAR	SH UH G ER
SUGARS	SH UH G ER Z
SULPHONATION	S AH L F AH N EY SH AH N
SULPHUR	S AH L F ER
SUPER	S UW P ER
SURFACE	S ER F AH S
SWARTS	S W AO R T S
SWEETENERS	S W IY T AH N ER Z
SWEETENERS(2)	S W IY T N ER Z
SWEETENING	S W IY T AH N IH NG
SWEETENING(2)	S W IY T N IH NG
SYNTHESIS	S IH N TH AH S AH S
SYNTHETIC	S IH N TH EH T IH K
T	T IY
TARGET	T AA R G AH T
TARGET(2)	T ER G AH T
TARGETS	T AA R G AH T S
TEFLON	T EH F L AH N
TEMPERATURE	T EH M P R AH CH ER
TEMPERATURE(2)	T EH M P ER AH CH ER
TERMINATING	T ER M AH N EY T IH NG
TERYLENE	T EH R AH L IY N
TEST	T EH S T
TETRAHEDRAL	T EH T R AH HH IY D R AH L
THEORY	TH IH R IY
THEORY(2)	TH IY ER IY
THERMODYNAMICS	TH ER M AH D AY N AE M IH K S
THERMOPLASTIC	TH ER M AH P L AE S T IH K
THERMOSETTING	TH ER M OW S EH T IH NG
TIEMANN	T IY M AH N
TOILET	T OY L AH T
TOLLENS	T OW L AH N Z
TRANQUILIZERS	T R AE NG K W AH L AY Z ER Z
TRANS	T R AE N Z
TRANSFER	T R AE N S F ER
TRANSITION	T R AE N Z IH SH AH N
TRANSPARENT	T R AE N S P EH R AH N T
TRISACCHARIDES	T R AH S AE K AH R AY D Z
TYNDALL	T IH N D AH L
ULTRAFILTRATION	AH L T R AH F IH L T R EY SH AH N
UNIDENTATE	AH N AY D EH N T AH T
UNIMOLECULAR	Y UW N IH M AH L EH K Y AH L ER
UNIT	Y UW N AH T
UNIT(2)	Y UW N IH T
UNITS	Y UW N AH T S
UNITS(2)	Y UW N IH T S
V	V IY
VACANCY	V EY K AH N S IY
VALENCE	V EY L AH N S
VAN	V AE N
VAPOUR	V AE P AH R
VASODILATOR	V AH S AA D AH L EY T AH R
VICINAL	V IH S AH N AH L
VINYLIC	V AY N AH L IH K
VITAMINS	V AY T AH M AH N Z
VOIDS	V OY D Z
VOLHARD	V OW L HH AH R D
VOLTAIC	V OW L T EY IH K
VULCANISATION	V AH L K AE N AH S EY SH AH N
WAAL	W AA L
WASHING	W AA SH IH NG
WATER	W AO T ER
WEAK	W IY K
WERNERS	W AH R N AH R Z
WHEATSTONE	W IY T S T OW N
WHITE	W AY T
WHITE(2)	HH W AY T
WILLIAMSON	W IH L Y AH M S AH N
WITHDRAWING	W IH TH D R AO IH NG
WITHDRAWING(2)	W IH DH D R AO IH NG
WOLFF	W UH L F
WROUGHT	R AO T
WURTZ	W ER T S
ZELINSKY	Z IH L IH N S K IY
ZEOLITES	Z IY AH L AY T S
ZERO	Z IY R OW
ZETA	Z EY T AH
ZIEGLER	Z IY G L ER
ZONE	Z OW N
ZWITTER	Z W IH T AH R
CENTRES	S EH N T ER Z
F	EH F
ANISOTROPY	AE N AY S AA T R AH P IY
CUBE	K Y UW B